that	th	at
not	n	ot
all		all
more	m	ore
will	w	ill
can	c	an
may	m	ay
what	wh	at
click	cl	ick
than	th	an
price	pr	ice
date	d	ate
back	b	ack
top	t	op
name	n	ame
state	st	ate
day	d	ay
make	m	ake
best	b	est
well	w	ell
map	m	ap
way	w	ay
great	gre	at
store	st	ore
line	l	ine
right	r	ight
take	t	ake
black	bl	ack
link	l	ink
same	s	ame
game	g	ame
think	th	ink
law	l	aw
guide	gu	ide
shop	sh	op
small	sm	all
rate	r	ate
main	m	ain
call	c	all
shall	sh	all
still	st	ill
man	m	an
sale	s	ale
stock	st	ock
join	jo	in
west	w	est
gay	g	ay
plan	pl	an
hot	h	ot
say	s	ay
test	t	est
play	pl	ay
got	g	ot
side	s	ide
sell	s	ell
night	n	ight
pay	p	ay
light	l	ight
might	m	ight
cell	c	ell
track	tr	ack
tell	t	ell
lot	l	ot
aug	a	ug
bill	b	ill
thing	th	ing
cheap	che	ap
rock	r	ock
edit	ed	it
bank	b	ank
weight	w	eight
loan	lo	an
wide	w	ide
quick	qu	ick
lake	l	ake
chat	ch	at
bit	b	it
stay	st	ay
mean	me	an
king	k	ing
drug	dr	ug
cash	c	ash
bay	b	ay
stop	st	op
came	c	ame
fine	f	ine
sat	s	at
zip	z	ip
nice	n	ice
score	sc	ore
flash	fl	ash
choice	cho	ice
male	m	ale
late	l	ate
fall	f	all
win	w	in
spring	spr	ing
voice	vo	ice
hill	h	ill
thank	th	ank
hall	h	all
ship	sh	ip
kit	k	it
wall	w	all
wine	w	ine
est		est
bring	br	ing
bin	b	in
guest	gu	est
van	v	an
skin	sk	in
ring	r	ing
pop	p	op
rest	r	est
hit	h	it
string	str	ing
pack	p	ack
core	c	ore
min	m	in
block	bl	ock
fat	f	at
saw	s	aw
trip	tr	ip
fan	f	an
cat	c	at
jack	j	ack
flat	fl	at
scale	sc	ale
frame	fr	ame
clean	cle	an
skip	sk	ip
jump	j	ump
ball	b	all
fit	f	it
pain	p	ain
root	ro	ot
ice		ice
pink	p	ink
shot	sh	ot
foot	fo	ot
heat	he	at
bug	b	ug
flight	fl	ight
fuck	f	uck
wait	wa	it
pick	p	ick
cock	c	ock
drop	dr	op
rank	r	ank
chain	ch	ain
fill	f	ill
boat	bo	at
brain	br	ain
eight		eight
vice	v	ice
truck	tr	uck
ray	r	ay
gain	g	ain
lack	l	ack
train	tr	ain
frank	fr	ank
clip	cl	ip
fight	f	ight
height	h	eight
drink	dr	ink
eat	e	at
dell	d	ell
seat	se	at
tip	t	ip
mine	m	ine
dan	d	an
beat	be	at
hide	h	ide
hip	h	ip
nine	n	ine
spot	sp	ot
clock	cl	ock
dot	d	ot
rain	r	ain
ride	r	ide
cap	c	ap
ink		ink
dick	d	ick
bell	b	ell
pin	p	in
raw	r	aw
kill	k	ill
plug	pl	ug
hat	h	at
plate	pl	ate
plain	pl	ain
dean	de	an
jean	je	an
hop	h	op
hell	h	ell
fruit	fru	it
draw	dr	aw
suck	s	uck
stick	st	ick
slide	sl	ide
lock	l	ock
tank	t	ank
pan	p	an
slot	sl	ot
gray	gr	ay
hate	h	ate
rice	r	ice
loop	lo	op
boot	bo	ot
shell	sh	ell
vat	v	at
twin	tw	in
split	spl	it
twice	tw	ice
suit	su	it
chip	ch	ip
sit	s	it
bright	br	ight
treat	tre	at
strip	str	ip
nick	n	ick
plot	pl	ot
pump	p	ump
threat	thre	at
scan	sc	an
blank	bl	ank
tight	t	ight
sin	s	in
meat	me	at
gate	g	ate
wing	w	ing
jay	j	ay
gap	g	ap
luck	l	uck
crack	cr	ack
smoke	sm	oke
cake	c	ake
till	t	ill
ran	r	an
ill		ill
lay	l	ay
thin	th	in
sick	s	ick
skill	sk	ill
crash	cr	ash
mall	m	all
spray	spr	ay
pat	p	at
fell	f	ell
shock	sh	ock
rack	r	ack
pride	pr	ide
throat	thro	at
tall	t	all
quest	qu	est
wake	w	ake
shit	sh	it
thick	th	ick
pine	p	ine
rick	r	ick
mill	m	ill
chest	ch	est
sight	s	ight
clay	cl	ay
kick	k	ick
pot	p	ot
wright	wr	ight
slip	sl	ip
pill	p	ill
swing	sw	ing
lat	l	at
shoot	sho	ot
spin	sp	in
wash	w	ash
shore	sh	ore
knight	kn	ight
soap	so	ap
punk	p	unk
coat	co	at
tit	t	it
mice	m	ice
ban	b	an
wrap	wr	ap
spoke	sp	oke
stroke	str	oke
strap	str	ap
crop	cr	op
sing	s	ing
stack	st	ack
trunk	tr	unk
juice	ju	ice
fame	f	ame
rap	r	ap
tin	t	in
rat	r	at
drunk	dr	unk
broke	br	oke
quit	qu	it
grill	gr	ill
grain	gr	ain
tale	t	ale
coin	co	in
fake	f	ake
mat	m	at
cheat	che	at
tan	t	an
mate	m	ate
chuck	ch	uck
dale	d	ale
brake	br	ake
strain	str	ain
stuck	st	uck
span	sp	an
joke	j	oke
ash		ash
bean	be	an
float	flo	at
tap	t	ap
wheat	whe	at
bride	br	ide
stat	st	at
pray	pr	ay
flame	fl	ame
pit	p	it
spell	sp	ell
struck	str	uck
freight	fr	eight
duck	d	uck
drill	dr	ill
trick	tr	ick
blame	bl	ame
sink	s	ink
brick	br	ick
grip	gr	ip
ide		ide
snap	sn	ap
swap	sw	ap
flip	fl	ip
rip	r	ip
chick	ch	ick
tray	tr	ay
bat	b	at
lip	l	ip
sap	s	ap
slight	sl	ight
snake	sn	ake
trap	tr	ap
priest	pri	est
nat	n	at
shaw	sh	aw
crap	cr	ap
fate	f	ate
spice	sp	ice
trash	tr	ash
lit	l	it
dump	d	ump
shake	sh	ake
clan	cl	an
shame	sh	ame
rug	r	ug
tide	t	ide
funk	f	unk
buck	b	uck
smell	sm	ell
pest	p	est
jill	j	ill
hack	h	ack
junk	j	unk
sake	s	ake
lean	le	an
drain	dr	ain
gore	g	ore
dash	d	ash
lap	l	ap
jake	j	ake
ping	p	ing
dice	d	ice
dock	d	ock
dame	d	ame
ate		ate
whale	wh	ale
fin	f	in
shine	sh	ine
dip	d	ip
hash	h	ash
hay	h	ay
pale	p	ale
nest	n	est
cop	c	op
gale	g	ale
stan	st	an
crest	cr	est
sip	s	ip
spank	sp	ank
spine	sp	ine
feat	fe	at
wan	w	an
scoop	sco	op
blink	bl	ink
goat	go	at
whore	wh	ore
dat	d	at
knock	kn	ock
wit	w	it
knit	kn	it
mug	m	ug
stake	st	ake
din	d	in
skate	sk	ate
khan	kh	an
lin	l	in
leap	le	ap
swan	sw	an
scat	sc	at
bash	b	ash
tot	t	ot
neat	ne	at
slice	sl	ice
bump	b	ump
sweat	swe	at
quake	qu	ake
twain	tw	ain
chill	ch	ill
tick	t	ick
bot	b	ot
drake	dr	ake
wap	w	ap
prop	pr	op
splash	spl	ash
chin	ch	in
squash	squ	ash
straw	str	aw
stein	ste	in
spill	sp	ill
snack	sn	ack
bore	b	ore
slate	sl	ate
init	in	it
bake	b	ake
scrap	scr	ap
sock	s	ock
vest	v	est
gill	g	ill
nay	n	ay
vine	v	ine
vale	v	ale
clash	cl	ash
ale		ale
stain	st	ain
coke	c	oke
wore	w	ore
lick	l	ick
whip	wh	ip
nan	n	an
plump	pl	ump
hank	h	ank
sore	s	ore
aide	a	ide
thrice	thr	ice
evan	ev	an
shrink	shr	ink
mack	m	ack
smash	sm	ash
mock	m	ock
ore		ore
nip	n	ip
vein	ve	in
hale	h	ale
bait	ba	it
lame	l	ame
knot	kn	ot
coop	co	op
lump	l	ump
hug	h	ug
slash	sl	ash
wat	w	at
ruin	ru	in
trump	tr	ump
strait	stra	it
heap	he	ap
jaw	j	aw
snoop	sno	op
sting	st	ing
shack	sh	ack
flap	fl	ap
thrill	thr	ill
quot	qu	ot
flop	fl	op
woke	w	oke
troop	tro	op
flock	fl	ock
kat	k	at
hunk	h	unk
chap	ch	ap
stoke	st	oke
tack	t	ack
sack	s	ack
nap	n	ap
brock	br	ock
rash	r	ash
vain	v	ain
fore	f	ore
slick	sl	ick
chunk	ch	unk
gan	g	an
crate	cr	ate
twink	tw	ink
kin	k	in
chop	ch	op
hoop	ho	op
shrine	shr	ine
brit	br	it
shin	sh	in
flaw	fl	aw
flick	fl	ick
lug	l	ug
swell	sw	ell
wink	w	ink
wight	w	ight
crank	cr	ank
jin	j	in
stall	st	all
tuck	t	uck
ling	l	ing
grin	gr	in
spit	sp	it
mot	m	ot
rot	r	ot
cain	c	ain
dwell	dw	ell
dine	d	ine
slap	sl	ap
paw	p	aw
cit	c	it
plat	pl	at
slack	sl	ack
gin	g	in
pap	p	ap
dug	d	ug
lest	l	est
claw	cl	aw
writ	wr	it
lore	l	ore
chit	ch	it
drip	dr	ip
mop	m	op
cot	c	ot
stray	str	ay
reap	re	ap
drank	dr	ank
glide	gl	ide
bop	b	op
trait	tra	it
sling	sl	ing
quay	qu	ay
slug	sl	ug
yell	y	ell
rake	r	ake
bunk	b	unk
dit	d	it
ding	d	ing
thug	th	ug
jug	j	ug
poop	po	op
swine	sw	ine
mash	m	ash
pug	p	ug
tat	t	at
tug	t	ug
pip	p	ip
puck	p	uck
stash	st	ash
stride	str	ide
sway	sw	ay
git	g	it
clap	cl	ap
poke	p	oke
twill	tw	ill
brink	br	ink
jock	j	ock
swat	sw	at
smack	sm	ack
sine	s	ine
bray	br	ay
choke	ch	oke
gall	g	all
slit	sl	it
zack	z	ack
fay	f	ay
fink	f	ink
stump	st	ump
tay	t	ay
thine	th	ine
plight	pl	ight
bing	b	ing
shank	sh	ank
leash	le	ash
muck	m	uck
pore	p	ore
grit	gr	it
slain	sl	ain
tame	t	ame
plank	pl	ank
ting	t	ing
rink	r	ink
scot	sc	ot
wick	w	ick
peat	pe	at
twat	tw	at
sunk	s	unk
ait	a	it
hin	h	in
tore	t	ore
dunk	d	unk
snip	sn	ip
crore	cr	ore
kip	k	ip
blot	bl	ot
seine	se	ine
rin	r	in
ain		ain
splice	spl	ice
zap	z	ap
yoke	y	oke
loot	lo	ot
stale	st	ale
hap	h	ap
cline	cl	ine
sop	s	op
moan	mo	an
sank	s	ank
bale	b	ale
cate	c	ate
lice	l	ice
cay	c	ay
mink	m	ink
dill	d	ill
moot	mo	ot
rein	re	in
gump	g	ump
bran	br	an
ell		ell
cling	cl	ing
skunk	sk	unk
squat	squ	at
crock	cr	ock
fray	fr	ay
flank	fl	ank
sash	s	ash
blight	bl	ight
thrash	thr	ash
pluck	pl	uck
prick	pr	ick
brat	br	at
slump	sl	ump
dap	d	ap
stink	st	ink
jest	j	est
cray	cr	ay
flake	fl	ake
pate	p	ate
snug	sn	ug
spline	spl	ine
whine	wh	ine
prank	pr	ank
gait	ga	it
hump	h	ump
fright	fr	ight
brine	br	ine
shay	sh	ay
lash	l	ash
nit	n	it
brill	br	ill
crit	cr	it
whit	wh	it
quill	qu	ill
sill	s	ill
groin	gro	in
frat	fr	at
swain	sw	ain
lain	l	ain
shale	sh	ale
snell	sn	ell
oat	o	at
bloke	bl	oke
prin	pr	in
scop	sc	op
droit	dro	it
wank	w	ank
gat	g	at
haw	h	aw
thaw	th	aw
whack	wh	ack
trot	tr	ot
shrug	shr	ug
wot	w	ot
slay	sl	ay
swank	sw	ank
spake	sp	ake
fling	fl	ing
bock	b	ock
grate	gr	ate
yap	y	ap
swore	sw	ore
daw	d	aw
sump	s	ump
zest	z	est
yank	y	ank
spat	sp	at
rit	r	it
shrunk	shr	unk
skit	sk	it
dop	d	op
knack	kn	ack
doit	do	it
bap	b	ap
fop	f	op
sot	s	ot
pall	p	all
moat	mo	at
spore	sp	ore
trop	tr	op
soot	so	ot
tain	t	ain
kink	k	ink
chore	ch	ore
wop	w	op
loin	lo	in
smit	sm	it
clot	cl	ot
hoot	ho	ot
kale	k	ale
chock	ch	ock
yip	y	ip
quack	qu	ack
maw	m	aw
groan	gro	an
swoop	swo	op
gnat	gn	at
squaw	squ	aw
smug	sm	ug
brash	br	ash
bate	b	ate
thump	th	ump
lop	l	op
kain	k	ain
gip	g	ip
twine	tw	ine
flack	fl	ack
jot	j	ot
spunk	sp	unk
engin	eng	in
swot	sw	ot
rump	r	ump
hock	h	ock
chine	ch	ine
hoke	h	oke
shrill	shr	ill
guan	gu	an
cleat	cle	at
yaw	y	aw
fain	f	ain
slat	sl	at
crick	cr	ick
tine	t	ine
stoop	sto	op
spay	sp	ay
spate	sp	ate
scran	scr	an
trice	tr	ice
splat	spl	at
dank	d	ank
roan	ro	an
clump	cl	ump
squall	squ	all
toot	to	ot
snot	sn	ot
ake		ake
wack	w	ack
whoop	who	op
anat	an	at
zing	z	ing
scrip	scr	ip
crump	cr	ump
quin	qu	in
gash	g	ash
bloat	blo	at
kyat	ky	at
wale	w	ale
slaw	sl	aw
hick	h	ick
trine	tr	ine
bice	b	ice
sloop	slo	op
snore	sn	ore
quell	qu	ell
caw	c	aw
blip	bl	ip
hight	h	ight
kine	k	ine
snuck	sn	uck
chump	ch	ump
scoot	sco	ot
pleat	ple	at
swash	sw	ash
clank	cl	ank
rall	r	all
fug	f	ug
wean	we	an
dink	d	ink
bight	b	ight
gest	g	est
prat	pr	at
jaap	ja	ap
clack	cl	ack
sain	s	ain
cran	cr	an
